%%%%%%%%
%G     %
% %%%  %
%.%G   %
% %%%  %
%     G%
%%%%%%%%
